####################
######## X##########
##S##X## # ####### #
           D       F
### #### #####P#####
##E #### ###########
#######K  ##########
####################