##########      #####
E        # ### ##  P#
# # # # ## ### ## ###
# # # #    #X   # ###
# # # ########### ###
# # #               #
# # ###############D#
# #             S## F
# ## #### ####X# ####
# ###X##### #### ####
#                K###
#####################