####################
########  ##########
## ## ## # ####### #
        E          F
### #### ##### #####
##  #### ###########
#######   ##########
####################